111111111111111111111111111111
100000000000001000000000000001
100000001111101111100000000001
100000001000000000100000000001
100000001000111110100000000001
100000001000000010100000000001
100000001111110010111111000001
100000000000010000000001000001
100000000000010000000001000001
100000011111110111111001000001
100000010000000000001001000001
100000010000000000001001000001
100000011111111111111001000001
100000000000000000001000000001
10P0000000000000000010000E0001
111111111111111111111111111111
