111111111
1P0000001
101111101
1C00100E1
101011101
1C0000001
111111111

