111111
100001
101101
100001
1C0E01
111111
