111111111
1P00CC111
101101111
10C001111
1C0E01111
111111111
