1111111
1P000C1
1011011
1C0C0E1
1011011
1111111
