1111111111111111111111111111111111111111111111111111111111111111111111111111111111111111111111111111111111111111111111111111
1P0000000000C00000000011111100000000000000000C000000000000000000C00000000111000000000000000000000000000000000000000000000001
1000000011111000000000110000110000000000000000111000000000001111100000000000011000000000000000000C00000000000000000000000001
100C0000110001100000001000000100000000000000000001100000000000000000000000000010000000000000000000C00000C0000000000000000001
10000000100000111111011000001111110000000000000000010000000000000000000000000000111100000000000C0000000000000000000000000001
100000001000000000000010000000000010000011110000000000011111000000000000011111000000011000000000C000000000000000000000000001
100C000001000000000000C000000000000C000010000000000000010000000000000000100000000000010000000000000000000C000000000000000011
1000000000000000000000111100000000000000011000000000000100000000000000001000000000000000000000C00000000000000000000000000011
10000000000000000000001000000000000000000001000000000001111000000000000010000000000000000000C0000000000000000000000000000011
111100000000000000000010000000000000000000000000000000000000000000000000100000000000000000000C000000000000000000000000000011
1C00000000000000000000100000011111000000000000000000000000000011111000001000000000000000000000000000000000C00000000000000011
100000000000000000000010000000000010000000000000000000000000000000010000000000000000000000000000000C000000000000000000000011
10000000001111100000011000000000001000000001111100000001111100000001000000000000000000000000000000000000000C0000000000000011
100C000000100001000000100000000000010000000000001000000100001000000C10000000000000000001000000000000000000000000000000000011
1000000001000010000001000000000000C00000000000110000011000100000000000000000000000000000000000000011100000000000000000000011
1000000001000010000001111100000000000000000000010000000000110000000000000000000000000000100000000000C00000000000000000000011
1000000001000010000000000100000000000000000000001000000000001000000000000000000000000000010000000000000000000000000000000011
100000000C00001C00000000001000000000000000000000011000000000010000000000000000000000000000000000000000000000C000000000000011
1000000000000000000000000001000000000000111111000001000000000111110000000000000000000000000100000000000000000000000000000011
1000000000000000000000000001000000000000100000000001000000000100000000000000000000000000001000000000000000000000000000000011
1000000000000000000000000001000000000000100000000001000000000100000000000000000000000000000000000000000000000C00000000000011
1000000000000000000000000001100000000000111111000001100000000111110000000000000000000100000000000000C000000000000000000000C1
1C000000000000000000000000001000000000000000000000001000000000000000000000000000000000100000000000000000000000000000000000C1
100000000000000000000000000C000000000000000000000000C000000000000000000000000000000000000000000000000000000000C0000000000E01
1111111111111111111111111111111111111111111111111111111111111111111111111111111111111111111111111111111111111111111111111111
