11111111
1P001C01
10E0C0C1
11111111
